为徐敬业讨武曌檄	wei'xu'jing'ye'tao'wu'zhao'xi	0
伪临朝武氏者	wei'lin'chao'wu'shi'zhe	0
性非和顺	xing'fei'he'shun	0
地实寒微	di'shi'han'wei	0
昔充太宗下陈	xi'chong'tai'zong'xia'chen	0
曾以更衣入侍	ceng'yi'geng'yi'ru'shi	0
洎乎晚节	ji'hu'wan'jie	0
秽乱春宫	hui'luan'chun'gong	0
潜隐先帝之私	qian'yin'xian'di'zhi'si	0
阴图后房之嬖	yin'tu'hou'fang'zhi'bi	0
入门见嫉	ru'men'jian'ji	0
蛾眉不肯让人	e'mei'bu'ken'rang'ren	0
掩袖工谗	yan'xiu'gong'chan	0
狐媚偏能惑主	hu'mei'pian'neng'huo'zhu	0
践元于翚翟	jian'yuan'yu'hui'di	0
陷吾君于聚麀	xian'wu'jun'yu'ju'you	0
加以虺蜴为心	jia'yi'hui'yi'wei'xin	0
豺狼成性	chai'lang'cheng'xing	0
近狎邪僻	jin'xia'xie'pi	0
残害忠良	can'hai'zhong'liang	0
杀姊屠兄	sha'zi'tu'xiong	0
弑君鸩母	shi'jun'zhen'mu	0
人神之所同嫉	ren'shen'zhi'suo'tong'ji	0
天地之所不容	tian'di'zhi'suo'bu'rong	0
犹复包藏祸心	you'fu'bao'cang'huo'xin	0
窥窃神器	kui'qie'shen'qi	0
君之爱子	jun'zhi'ai'zi	0
幽在别宫	you'zai'bie'gong	0
贼之宗盟	zei'zhi'zong'meng	0
委以重任	wei'yi'zhong'ren	0
呜呼	wu'hu	0
霍子孟之不作	huo'zi'meng'zhi'bu'zuo	0
朱虚侯之已亡	zhu'xu'hou'zhi'yi'wang	0
鷰啄皇孙	yan'zhuo'huang'sun	0
知汉祚之将尽	zhi'han'zuo'zhi'jiang'jin	0
龙漦帝后	long'chi'di'hou	0
识夏庭之遽衰	shi'xia'ting'zhi'ju'shuai	0
敬业皇唐旧臣	jing'ye'huang'tang'jiu'chen	0
公侯冢子	gong'hou'zhong'zi	0
奉先君之成业	feng'xian'jun'zhi'cheng'ye	0
荷本朝之厚恩	he'ben'chao'zhi'hou'en	0
宋微子之兴悲	song'wei'zi'zhi'xing'bei	0
良有以也	liang'you'yi'ye	0
袁君山之流涕	yuan'jun'shan'zhi'liu'ti	0
岂徒然哉	qi'tu'ran'zai	0
是用气愤风云	shi'yong'qi'fen'feng'yun	0
志安社稷	zhi'an'she'ji	0
因天下之失望	yin'tian'xia'zhi'shi'wang	0
顺宇内之推心	shun'yu'nei'zhi'tui'xin	0
爰举义旗	yuan'ju'yi'qi	0
以清妖孽	yi'qing'yao'nie	0
南连百越	nan'lian'bai'yue	0
北尽三河	bei'jin'san'he	0
铁骑成群	tie'qi'cheng'qun	0
玉轴相接	yu'zhou'xiang'jie	0
海陵红粟	hai'ling'hong'su	0
仓储之积靡穷	cang'chu'zhi'ji'mi'qiong	0
江浦黄旗	jiang'pu'huang'qi	0
匡复之功何远	kuang'fu'zhi'gong'he'yuan	0
班声动而北风起	ban'sheng'dong'er'bei'feng'qi	0
剑气冲而南斗平	jian'qi'chong'er'nan'dou'ping	0
喑呜则山岳崩颓	yin'wu'ze'shan'yue'beng'tui	0
叱咤则风云变色	chi'zha'ze'feng'yun'bian'se	0
以此制敌	yi'ci'zhi'di	0
何敌不摧	he'di'bu'cui	0
以此图功	yi'ci'tu'gong	0
何功不克	he'gong'bu'ke	0
公等或居汉地	gong'deng'huo'ju'han'di	0
或协周亲	huo'xie'zhou'qin	0
或膺重寄于话言	huo'ying'zhong'ji'yu'hua'yan	0
或受顾命于宣室	huo'shou'gu'ming'yu'xuan'shi	0
言犹在耳	yan'you'zai'er	0
忠岂忘心	zhong'qi'wang'xin	0
一抔之土未干	yi'pou'zhi'tu'wei'gan	0
六尺之孤何托	liu'chi'zhi'gu'he'tuo	0
倘能转祸为福	tang'neng'zhuan'huo'wei'fu	0
送往事居	song'wang'shi'ju	0
共立勤王之勋	gong'li'qin'wang'zhi'xun	0
无废大君之命	wu'fei'da'jun'zhi'ming	0
凡诸爵赏	fan'zhu'jue'shang	0
同指山河	tong'zhi'shan'he	0
若其眷恋穷城	ruo'qi'juan'lian'qiong'cheng	0
徘徊歧路	pai'huai'qi'lu	0
坐昧先机之兆	zuo'mei'xian'ji'zhi'zhao	0
必贻后至之诛	bi'yi'hou'zhi'zhi'zhu	0
请看今日之域中	qing'kan'jin'ri'zhi'yu'zhong	0
竟是谁家之天下	jing'shi'shui'jia'zhi'tian'xia	0
秋日登洪府滕王阁饯别序	qiu'ri'deng'hong'fu'teng'wang'ge'jian'bie'xu	0
豫章故郡	yu'zhang'gu'jun	0
洪都新府	hong'dou'xin'fu	0
星分翼轸	xing'fen'yi'zhen	0
地接衡庐	di'jie'heng'lu	0
襟三江而带五湖	jin'san'jiang'er'dai'wu'hu	0
控蛮荆而引瓯越	kong'man'jing'er'yin'ou'yue	0
物华天宝	wu'hua'tian'bao	0
龙光射牛斗之墟	long'guang'she'niu'dou'zhi'xu	0
人杰地灵	ren'jie'di'ling	0
徐孺下陈蕃之榻	xu'ru'xia'chen'fan'zhi'ta	0
雄州雾列	xiong'zhou'wu'lie	0
俊彩星驰	jun'cai'xing'chi	0
台隍枕夷夏之交	tai'huang'zhen'yi'xia'zhi'jiao	0
宾主尽东南之美	bin'zhu'jin'dong'nan'zhi'mei	0
都督阎公之雅望	du'du'yan'gong'zhi'ya'wang	0
棨戟遥临	qi'ji'yao'lin	0
宇文新州之懿范	yu'wen'xin'zhou'zhi'yi'fan	0
襜帷暂驻	chan'wei'zan'zhu	0
十旬休暇	shi'xun'xiu'xia	0
胜友如云	sheng'you'ru'yun	0
千里逢迎	qian'li'feng'ying	0
高朋满座	gao'peng'man'zuo	0
腾蛟起凤	teng'jiao'qi'feng	0
孟学士之词宗	meng'xue'shi'zhi'ci'zong	0
紫电青霜	zi'dian'qing'shuang	0
王将军之武库	wang'jiang'jun'zhi'wu'ku	0
家君作宰	jia'jun'zuo'zai	0
路出名区	lu'chu'ming'qu	0
童子何知	tong'zi'he'zhi	0
躬逢胜饯	gong'feng'sheng'jian	0
时维九月	shi'wei'jiu'yue	0
序属三秋	xu'shu'san'qiu	0
潦水尽而寒潭清	lao'shui'jin'er'han'tan'qing	0
烟光凝而暮山紫	yan'guang'ning'er'mu'shan'zi	0
俨骖𬴂于上路	yan'can'fei'yu'shang'lu	0
访风景于崇阿	fang'feng'jing'yu'chong'a	0
临帝子之长洲	lin'di'zi'zhi'zhang'zhou	0
得仙人之旧馆	de'xian'ren'zhi'jiu'guan	0
层台耸翠	ceng'tai'song'cui	0
上出重霄	shang'chu'chong'xiao	0
飞阁流丹	fei'ge'liu'dan	0
下临无地	xia'lin'wu'di	0
鹤汀凫渚	he'ting'fu'zhu	0
穷岛屿之萦廻	qiong'dao'yu'zhi'ying'hui	0
桂殿兰宫	gui'dian'lan'gong	0
即冈峦之体势	ji'gang'luan'zhi'ti'shi	0
披绣闼	pi'xiu'ta	0
俯雕甍	fu'diao'meng	0
山原旷其盈视	shan'yuan'kuang'qi'ying'shi	0
川泽纡其骇瞩	chuan'ze'yu'qi'hai'zhu	0
闾阎扑地	lv'yan'pu'di	0
钟鸣鼎食之家	zhong'ming'ding'shi'zhi'jia	0
舸舰迷津	ge'jian'mi'jin	0
青雀黄龙之舳	qing'que'huang'long'zhi'zhu	0
云销雨霁	yun'xiao'yu'ji	0
彩彻区明	cai'che'qu'ming	0
落霞与孤鹜齐飞	luo'xia'yu'gu'wu'qi'fei	0
秋水共长天一色	qiu'shui'gong'chang'tian'yi'se	0
渔舟唱晚	yu'zhou'chang'wan	0
响穷彭蠡之滨	xiang'qiong'peng'li'zhi'bin	0
雁阵惊寒	yan'zhen'jing'han	0
声断衡阳之浦	sheng'duan'heng'yang'zhi'pu	0
遥襟甫畅	yao'jin'fu'chang	0
逸兴遄飞	yi'xing'chuan'fei	0
爽籁发而清风生	shuang'lai'fa'er'qing'feng'sheng	0
纤歌凝而白云遏	xian'ge'ning'er'bai'yun'e	0
睢园绿竹	sui'yuan'lv'zhu	0
气凌彭泽之樽	qi'ling'peng'ze'zhi'zun	0
邺水朱华	ye'shui'zhu'hua	0
光照临川之笔	guang'zhao'lin'chuan'zhi'bi	0
四美具	si'mei'ju	0
二难并	er'nan'bing	0
穷睇眄于中天	qiong'di'mian'yu'zhong'tian	0
极娱游于暇日	ji'yu'you'yu'xia'ri	0
天高地迥	tian'gao'di'jiong	0
觉宇宙之无穷	jue'yu'zhou'zhi'wu'qiong	0
兴尽悲来	xing'jin'bei'lai	0
识盈虚之有数	shi'ying'xu'zhi'you'shu	0
望长安于日下	wang'chang'an'yu'ri'xia	0
目吴会于云间	mu'wu'hui'yu'yun'jian	0
地势极而南溟深	di'shi'ji'er'nan'ming'shen	0
天柱高而北辰远	tian'zhu'gao'er'bei'chen'yuan	0
关山难越	guan'shan'nan'yue	0
谁悲失路之人	shui'bei'shi'lu'zhi'ren	0
萍水相逢	ping'shui'xiang'feng	0
尽是他乡之客	jin'shi'ta'xiang'zhi'ke	0
怀帝阍而不见	huai'di'hun'er'bu'jian	0
奉宣室以何年	feng'xuan'shi'yi'he'nian	0
时运不齐	shi'yun'bu'ji	0
命途多舛	ming'tu'duo'chuan	0
冯唐易老	feng'tang'yi'lao	0
李广难封	li'guang'nan'feng	0
屈贾谊于长沙	qu'jia'yi'yu'chang'sha	0
非无圣主	fei'wu'sheng'zhu	0
窜梁鸿于海曲	cuan'liang'hong'yu'hai'qu	0
岂乏明时	qi'fa'ming'shi	0
所赖君子安贫	suo'lai'jun'zi'an'pin	0
达人知命	da'ren'zhi'ming	0
老当益壮	lao'dang'yi'zhuang	0
宁移白首之心	ning'yi'bai'shou'zhi'xin	0
穷且益坚	qiong'qie'yi'jian	0
不坠青云之志	bu'zhui'qing'yun'zhi'zhi	0
酌贪泉而觉爽	zhuo'tan'quan'er'jue'shuang	0
处涸辙以犹懽	chu'he'zhe'yi'you'huan	0
北海虽赊	bei'hai'sui'she	0
扶摇可接	fu'yao'ke'jie	0
东隅已逝	dong'yu'yi'shi	0
桑榆非晚	sang'yu'fei'wan	0
孟尝高洁	meng'chang'gao'jie	0
空余报国之心	kong'yu'bao'guo'zhi'xin	0
阮籍猖狂	ruan'ji'chang'kuang	0
岂效穷途之哭	qi'xiao'qiong'tu'zhi'ku	0
三尺微命	san'chi'wei'ming	0
一介书生	yi'jie'shu'sheng	0
无路请缨	wu'lu'qing'ying	0
等终军之弱冠	deng'zhong'jun'zhi'ruo'guan	0
有怀投笔	you'huai'tou'bi	0
慕宗悫之长风	mu'zong'que'zhi'zhang'feng	0
舍簪笏于百龄	she'zan'hu'yu'bai'ling	0
奉晨昏于万里	feng'chen'hun'yu'wan'li	0
非谢家之宝树	fei'xie'jia'zhi'bao'shu	0
接孟氏之芳邻	jie'meng'shi'zhi'fang'lin	0
他日趋庭	ta'ri'qu'ting	0
叨陪鲤对	tao'pei'li'dui	0
今兹捧袂	jin'zi'peng'mei	0
喜托龙门	xi'tuo'long'men	0
杨意不逢	yang'yi'bu'feng	0
抚凌云而自惜	fu'ling'yun'er'zi'xi	0
钟期既遇	zhong'qi'ji'yu	0
奏流水以何惭	zou'liu'shui'yi'he'can	0
胜地不常	sheng'di'bu'chang	0
盛筵难再	sheng'yan'nan'zai	0
兰亭已矣	lan'ting'yi'yi	0
梓泽丘墟	zi'ze'qiu'xu	0
临别赠言	lin'bie'zeng'yan	0
幸承恩于伟饯	xing'cheng'en'yu'wei'jian	0
登高作赋	deng'gao'zuo'fu	0
是所望于群公	shi'suo'wang'yu'qun'gong	0
敢竭鄙诚	gan'jie'bi'cheng	0
恭疏短引	gong'shu'duan'yin	0
一言均赋	yi'yan'jun'fu	0
四韵俱成	si'yun'ju'cheng	0
请洒潘江	qing'sa'pan'jiang	0
各倾陆海云尔	ge'qing'lu'hai'yun'er	0
滕王高阁临江渚	teng'wang'gao'ge'lin'jiang'zhu	0
佩玉鸣鸾罢歌舞	pei'yu'ming'luan'ba'ge'wu	0
画栋朝飞南浦云	hua'dong'chao'fei'nan'pu'yun	0
珠帘暮卷西山雨	zhu'lian'mu'juan'xi'shan'yu	0
闲云潭影日悠悠	xian'yun'tan'ying'ri'you'you	0
物换星移几度秋	wu'huan'xing'yi'ji'du'qiu	0
阁中帝子今何在	ge'zhong'di'zi'jin'he'zai	0
槛外长江空自流	kan'wai'zhang'jiang'kong'zi'liu	0
